25 25
100 100
4 10 10 10 10 10 10 10 10 10 10 10 10 10 10 10 10 10 10 10 10 10 10 10 5
8 2  2  2  10  1  1  1  1  1  1  1  1  1  1  1  1  1  1  1  10  1  1  1  9
8 2  2  2  10  3  1  1  1  1  1  1  1  2  1  1  1  1  1  1  10  1  1  1  9
8 2  2  2  10  1  1  2  2  2  2  2  1  1  1  1  1  1  1  1  10  1  1  1  9
8 1  1  1  10  1  1  2  2  12 12 2  1  1  1  1  1  1  1  1  10  1  1  1  9
8 1  1  1  10  1  1  1  2  12 12 2  1  2  3  1  1  1  1  1  10  1  1  1  9
8 1  1  1  1  1  1  1  2  2  2  2  1  1  1  1  1  1  1  1  10  1  1  1  9
8 1  1  1  1  1  1  2  1  1  1  2  1  1  1  1  1  1  1  1  10  1  1  1  9
8 10 10 10 1  1  1  1  3  1  1  2  2  1  1  1  1  1  1  1  10  1  1  1  9
8 1  1  1  1  1  3  3  3  1  1  1  1  1  1  1  1  1  1  1  10  1  1  1  9
8 1  1  1  1  1  3  1  1  1  1  1  1  1  1  1  1  1  1  1  10  1  1  1  9
8 1  1  1  1  1  3  1  1  1  1  3  11  1  1  11  1  1  1  1  10  1  1  1  9
8 1  1  1  1  1  1  1  1  1  1  1  11  1  1  11  1  1  1  1  10  1  1  1  9
8 1  1  1  1  1  1  1  1  1  1  1  11  1  1  11  1  1  1  1  1  1  1  1  9
8 1  1  1  1  1  1  1  1  2  1  1  11  1  1  11  1  1  1  1  1  1  1  1  9
8 8  8  8 1  1  1  1  1  1  1  1  11  1  1  11  1  1  1  1  1  1  1  1  9
8 8  8  8  1  1  1  2  1  1  1  1  11  1  2  11  1  1  1  1  1  1  1  1  9
8 1  1  1  1  1  1  1  1  1  1  1  11  1  1  1  1  1  1  1  1  1  1  1  9
8 1  1  1  2  1  1  1  1  1  1  1  11  1  1  1  1  1  1  1  1  1  1  1  9
8 1  1  1  1  1  1  1  1  1  1  1  11  1  1  1  1  1  1  1  1  1  1  1  9
8 11  11  11  11  11  11  11 11  11 11  1  1  1  1  1  1  1  1  1  1  1  1  1  9
8 11  11  11  11  11  11  11 11  11  11  1  1 11  1  1  1  1  1  1  1  1  1  1  9
8 11  11 11  11  11  11  11  11  11  11  11  11 11  1  1  1  1  1  1  1  1  1  1  9
8 11  11  11  11  11  11  11  11  11  11  11  11 11  1  1  1  1  1  1  1  1  1  1  9
7 11 11 11 11 11 11 11 11 11 11 11 11 11 11 11 11 11 11 11 11 11 11 11 6